This the the best trance, club, progressive, acid jazz, trip hop, drum and bass, happy hardcore, old school rave mix you will ever hear. Thanks to Apell and some of my friends, this is some of my favorite songs of all time. Some of the below songs and artists do not match with the songs, because I was too lazy to fix them. Enjoy these songs guys, I do. SEED PLEASE!!!!






Believe	                Antiloop
Spiral	                Armin Van Buuren
Lady Blue	        Armin Van Buuren
Serenity	        Armin Van Buuren
Madagascar	        Art of Trance
Russia Privjet	        Basshunter
Best Rave Song	        Best Rave
Hot and Sexy	        Boosterz Inc
Ambient and Chill Out	Chicane
Red Skies	        Chicane
When things go Wrong	Classic Trance Nation
Classic 5	        Classic Trance Nation
M.I.K.E. Salvation	Plastic Boy
Unknown	                Cosmic Gate
Matrix Theme	        Crystal Method
Feel the Beat (Dark Mix Darude
Bitter Sweet	        Darude
Rush	                Darude
Oasis Club Mix	        Darude
Hard Radical (club)	DJ Bad Dysproz
Euroworld (club)	DJ Bad Dysproz
Dreamscape	        Dj Dado
Around the world (club)	Dj Equan vs. Racid
Resurrection	        Dj Loopy
Eternity	        Dj Mystic
Welcome Back	        Dj Perfection
Raindrops (original mix Dj Plocx
Escape Mix	        DJ QUICKSILVER
Ameno (remix of the era DJ QUICKSILVER
Trance Emotions	        DJ QUICKSILVER
Bitter Sweet	        DJ QUICKSILVER
Ayla	                Dj Tandu
Tantrix	                Dj Tiesto
Hes a Pirate	        Dj Tiesto
Time Gate	        Dj Tiesto
Eugina	                Dj Tiesto
Euphoria	        Dj Tiesto
Dark Blue	        Dj Tiesto
La Noche	        Dj Tiesto
Going up	        Dj Tiesto
White Noise	        Dj Tiesto
Far from over   	Dj Tiesto
Activate	        Dj Tiesto
I believe (tandu remix)	Dj Tiesto
Sparkles (magical remakeDj Tiesto
Airtight	        Dj Tiesto
Kalinka	                Dj Tiesto
Epic	                Dj Tiesto
Ice Rain	        Dj Tiesto
Lift off	        Dream Wave
Miami	                Firewave
What would Brian Boitano do	Freestylerz
Cheezebeats (Pimpin Mix)	Handz up! Rockerz
Deeply Disturbed	        Infected Mushroom
Mushi Mushi	                Infected Mushroom
Psycho	                        Infected Mushroom
Dr. Feelgood 2003	        Interphase
Break Up (A Traxx Remix)	Kim Sozzi
Bad Day (dj ozi rmx)	        Lawrence
Summer of Love (deepforces rmx)	Marc Korn
Find a place for music	        Matt Holler
Last night a Dj saved my life	Outatime
Crush	                        Paul Van Dyk
Nothing but you (club mix)	Paul Van Dyk
Unknown	                        Paul Van Dyk
Corrupted (Club mix)	        Robboz
Rise	                        Safri Duo
Samba Adagio	                Safri Duo
Played Alive	                Safri Duo
Milky Way (teenagerz Rmx)	Solar Patrol
The Beat (original rmx) 	Sonic Alive
Drum and Bass 2000	        Squarepusher
Be Alive! (Lasj rmx)	        Stain K
Japanese Techno	                Theory
James Last Cd	                Theory
Make some Noize- flashtune	Top 100
Hop and Pop- liquid bass	Top 100
Wild Going- nature inc	        Top 100
Hardstyle my Style- Starsplash	Top 100
Milka- v1r00z	                Top 100
Clubbing on Sunshine-Svenson	Top 100 vol 3 & Dance Providers 7
Morning Rain- Bass Rockers	Top 100 vol 3 & Dance Providers 7
R U ready- Pimp Code	        Top 100 vol 3 & Dance Providers 7
Dance at the Disco- Partyman	Top 100 vol 3 & Dance Providers 7
Oddworld- Earthshaker	        Top 100 vol 3 & Dance Providers 7
Everybody- Sound invaders	Top 100 vol 3 & Dance Providers 7
Top cum- Stian K 	        Top 100 vol 3 & Dance Providers 7
Welcome to Skateland- Dan J	Top 100 vol 3 & Dance Providers 7
Youre the one- Dj Ozi	        Top 100 vol 3 & Dance Providers 7
Frozen Flame- Jekyll and Hyde	Top 100 vol 3 & Dance Providers 7
Face down ass up- Dj Splash	Top 100 vol 3 & Dance Providers 7
Ladida (freesylerz rmz)- Baracuda	Top 100 vol 3 & Dance Providers 7
Hava Nagila (radio)- Alex Megane	Top 100 vol 3 & Dance Providers 7
Energy- Dj Matt	                        Top 100 vol 3 & Dance Providers 7
What is love 2007- Speedmaster pjt	Top 100 vol 3 & Dance Providers 7
Dust to dust- Special D.	        Top 100 vol 4
Life goes on (org.)- Raaban Inc. 	Top 100 vol 4
Cotton Eyed Joe (splash rmx)- Rednex	Top 100 vol 4
This is my bass- Dj Splash	Top 100 vol 4
Pussy pussy- K Tune	        Top 100 vol 4
Lets Go- Dj Roxx	        Top 100 vol 4
Jumping Pumping Remix- Dj Roxx	Top 100 vol 4
Paradise on E- B0unc3	        Top 100 vol 4
Trance Melody- Night Power	Top 100 vol 4
Beat and bass- Hard Mission	Top 100 vol 4
Bass Fly- Bass Rockers	        Top 100 vol 4
Beat it- DJ Equan	        Top 100 vol 4
Falling- Zapflap	        Top 100 vol 4
Ready for take off- Wasabi	Top 100 vol 4
You were there- A1 Projekt	Top 100 vol 8
Partyline- Rythminsider	        Top 100 vol 8
Culmination- Melliot	        Top 100 vol 8 
Anthem- Disco Superstars	Top 100 vol 8	
Pure Thrust- Basic Dawn	        Top 100 vol 8
Imagine Yourself- Powerface	Top 100 vol 8
Its a rainy Day 2007- Sonic Alive	Top 100 vol 8
Satisfy my Love- CJ stone	        Top 100 vol 8
Sweet Love- DJ Cargo	                Top 100 vol 8
Galaktika- Dj Dean	                Top 100 vol 8
2 know good(teenagers radio)- Milkesh	Top 100 vol 8
Music Style- Andree Traxxer	        Top 100 vol 8
The Sequence Stuff- Liquid DJ Team	Top 100 vol 7
Jump(radio)- MBrother	        Top 100 vol 7
Get up for dancecore- Raveboy	Top 100 vol 7
Bleeps N Things- Hit House	Top 100 vol 7
 
Techno Dance	                Trance Nation 2003
Sun is Shining (Dan winter rmx)	Yanou
Face Down Ass Up	        Zone Breaker
Bass From my Zoul	        Zoulfactory
Track 2	        CD 1
Track 3	        CD 1
Track 4	        CD 1
Old Skool	CD 1
Track 5	        CD 1
Titanic	        CD 1
Track 6	        CD 1
Track 7	        CD 1
Fallen Angel	CD 1
Ahh ohh	        CD 1
Track 9	        CD 1
Remixed	        CD 1
Track 10	CD 1
Slightly SoundlyCD 1
Victorious	CD 1
Tech 1	        CD 1
Track 13	CD 1
Track 14	CD 1
Track 15	CD 1
Track 16	CD 1
Yeah     	CD 1