roxette - the centre of the heart
titiyo - come along
håkan hellström - en vän med en bil
the ark - it takes a fool to remain sane
shebang - romeo
a-teens - halfway around the world
standfast - carcrashes
daniel lemma - id i used to love you
feven - dom tio budorden
petter - så klart
marie fredriksson - äntligen
joakim hillson - vacker utan spackel
lucky street - girl next door
kinnda - freak you out
peter jöback - higher
da buzz - do you want me
friends - listen tou your heartbeat
markoolio - mera mål
cardigans - erase & rewind
eagle-eye cherry - save tonight
robyn - show me love
kent - musik non stop
andreas johnson - glorious
patrik isaksson - du får göra vad du vill
ges - när vi gräver guld i usa
eva dahlgren - vem tänder stjärnorna
bo kaspers osketster - allt ljus på mig
lisa nilsson - himlen runt hörnet
mauro scocco - till dem ensamma
jennifer brown - tuseday afternoon
meja - all 'bout the money
jessica folker - how will i know
staffan hellstrand - lilla fågel blå
tomas ledin - snart tystar musiken



INGEN COVERS!!!! SORRY!!
