Summer Jam 2007 

CD1    
Bob Sinclar: Sound Of Freedom    
Infernal: I wonÂ´t Be Crying    
Booty Luv: Boogie 2Nite    
David Guetta vs The Egg: Love DonÂ´t Let Me Go    
Secondtunez: Sommaren Ã?r HÃ¤r Igen    
Lazard: Your Heart Keep Burning    
Fedde Le Grand: Take No Shhh    
Armand Van Helden: Touch Your Toes    
Jaymen: Ooh La Lishious    
Bombay Rockers - Beautiful    
Jojo: Too Little, Too Late    
Mighty Dub Kaz: Magic Carpet Ride 2007    
Tom Novy: The Power    
KLM Music: I Need A Miracle    
Canamore: IÂ´ve Got This Feeling    
Byron Strigly: Get Up    
Jaydee: Plastic Dreams    
Good Fader: Goodfader Love Theme    
Viro - Adam    
Basshunter vs Patrick & Lilen: Vifta Med HÃ¤nderna   
 
CD2    
Kabajsarna: SÃ¥ng Om Ingenting    
Enur Feat Natasha - Calabra    
Michael Gray: Somewhere Beyond    
Global Deejays: Get Up    
Carmiccon - Kamado    
Squeetze Up: WhoÂ´s That Girl    
Yamboo Feat Dr Alban: Sing Hallelujah 2007    
Ã?me - Rej    
Erick E: The Beat Is RockinÂ´    
Beatfreakz: Superfreak    
Starzoom: Billie Jean    
Alba vs Rockefeller: Sexual Healing    
Sunfreakz Feat Andrea Britton: Counting Down The Days    
Aycon: Divided    
Tune Up!: Colors Of The Rainbow    
Mason vs Princess Superstar - Perfect    
Fashion Victims: Koochi Koochi    
Eddie Thorneick: Deeper Love    
Dj Aligator: Meet Her At The Loveparade    
Dj Bamba: Honk If YouÂ´re Horny.
