This is my first torrent, a compilation of 28 romantic trance songs that you can listen to together with the love of your life. Enjoy...;)


Tracklist:

Adrima - I Can't Stand It.mp3
Aria - Ti Amo.mp3
Backslash ft. Dj Zola - Angels Way (Raveman).mp3
Bass 4 The Nation - Boys (Summertime Love).mp3
BassHunter - Utan Stjarnorna.mp3
Bermuda Loverz - My Girl (Ladidada).mp3
Cascada - Love Again.mp3
Cascada - One More Night.mp3
Central Seven - If I Were You.mp3
Crazy Frog - Last Christmas.mp3
DHT - Listen To Your Heart.mp3
Dj Dean - If I Could Be You.mp3
Dj Gollum - Take My Heart (Special D.).mp3
Dj Splash - My First Love.mp3
Dj Zitkus - You\'re My Angel (Nicole).mp3
Dune - I Kiss Your Lips.mp3
Gigi D\'Agostino - La Passion.mp3
Gigi D\'Agostino - You Spin Me Around.mp3
Hard Dance Mania Vol.9 - Like i Love You.mp3
Hi-Tack - Say Say Say (Waiting 4 U).mp3
Nightcore - Will My Heart Survive.mp3
Playhouse - I Think We Are Alone Now.m4a
Renegade Masterz - Nasty Girl.mp3
Rollergirl - Luv U More.mp3
Sylver - Take Me Back.mp3
The 2 Jays - Heartquake.mp3
Tune Up vs. Italobrothers - Colors Of The Rainbow.mp3
Yom Trax - The Sound (Verano).mp3