Had some time over to do another selection of my favorite italo disco clips.

Enjoy! ;-)
/neXium


--=   Best of Italo Disco Clips Vol 4   =--


Alan Cook - Bad Dream (Live)
Bad Boys Blue - Hungry for Love
Baltimora - Juke Box Boy
Deborah Kinley - All For You
Den Harrow - Bad Boy
Dresden China - Fire and Rain (Live @ P.I.T. '86)
Fancy - Slice me Nice
Gazebo - Masterpiece (Musikladen '83)
Karen & Chelle - Sugar Daddy
Kay Franzes - Take me and You'll Win
Lian Ross - Fantasy (Formel Eins)
Martinelli - Orient Express (Live @ DiscoRing)
Mike Mareen - Here I Am
P Lion - Dreams
Paul Lekakis - Boom Boom (Live)
Roni Griffith - Desire
Ryan Paris - Dolce Vita (Live @ Polish TV)
Sabrina Salerno - Hot Girl (Live @ Notte Italiana '87)
Sandy Marton - Exotic & Erotic (Formel Eins)
Sauvage - Do You Want Me (Live @ Pin Up Club '88)     
Savage - Celebrate
Scotch - Mirage
Silent Circle - Stop the Rain in the Night (Live @ KU '86)
Silicon Dream - Andromeda
Silver Pozzoli - Around my Dream (Formel Eins)
Spagna - Easy Lady
Stacey Q - I Love You
The Flirts - Helpless
The Twins - Not the Loving Kind (Musikladen)
Tom Hooker - Looking For Love (Live @ Festivalbar)
Tracy Spencer - Run to Me
Vanessa - Just A Game (Live @ Polnish TV)   (Short sample but very good)

And as a bonus. A special very rare clip. Classic Pre Italo from 1978! 
The Droids - The Force (Live @ DiscoRing) 
