THE RING: EL CÍRCULO / RINGU 


Género: Terror
País: Japón
Año:  1998
Duración: 98 mins. 
 
Ficha técnica  
Dirección - Hideo Nakata
Guión - Kôji Suzuki, Hiroshi Takahashi
Producción - Takashige Ichise, Shinya Kawai, Takenori Sento
Fotografía - Junichirô Hayashi
Música - Kenji Kawai
 
Ficha artística 
Nanako Matsushima - Reiko Asakawa
Miki Nakatani - Mai Takano
Hiroyuki Sanada - Ryuji Takayama
Hitomi Sato - Masami Kurahashi
Yoichi Numata - Takashi Yamamura
Yutaka Matsushige - Yoshino
Katsumi Muramatsu - Koichi Asakawa
Rikiya Otaka - Yoichi Asakawa 


Argumento 

Una leyenda urbana recorre los institutos de la ciudad, habla de una cinta maldita, quien ve esa cinta muere a los siete días en extrañas circunstancias. Esto le sucede a Tomoko, una chica que tras pasar unos días con unos amigos en una cabaña, es encontrada una semana después muerta con una expresión de terror en la cara. 
Reiko Asakawa, periodista y tía de Tomoko, esta investigando el rumor de la cinta maldita, entrevistando a varios chicos de institutos de la ciudad. A medida que avance en su investigación, llegará a descubrir que su sobrina también vió esa cinta. Unas fotos la llevaran a la cabaña donde su sobrina estuvo aquella noche, encontrando la misteriosa cinta. La periodista, no podrá esperar y la visionará. 
Una grabación a base de fotogramas entrelazados sin mucho sentido, donde pueden verse dos hombres arrastrándose, una mujer peinándose delante de un espejo y un extraño pozo, todo unido a unos extraños ruidos. En ese instante, recibe una llamada que le helará los huesos. Ahora ella también esta en peligro, y con ayuda de su exmarido intentará descubrir el origen de la cinta, adentrándose en un misterioso y aterrador secreto. 

 
Rip info:

Programa: DvDDecrypter

Origen DvD5

Video sin tocar

Extras: un par de fichas y acceso directo a escenas

Audio: español y japones, ambos 2 canales.

Subtitulos: español.

Region: PAL