MP3'3 

38 Special - Take Me Back to Paradise
ACDC- Back In Black
Bad Company - Shooting Star
Beatles Party Mix - Jive Bunny - Dance - 7 min.
Big And Rich - Kick My Ass
Bon Jovi - Wanted Dead Or Alive
Boston - More Than A Feeling
Brown Beaver Band - The Dark Side
Bruce Springsteen - Born in the USA
Chicago - Died in Your Arms Tonight
Cinderella - Don't Know What You Got Till It's Gone
Duran Duran - Hungry Like The Wolf
Europe - Carrie
Faster Pussycat - House Of Pain
Foghat - Fool for the City
Foreigner - Want To Know What Love Is
Guns And Roses - Knocking On Heavens Door
Huey Lewis and the News - The Power of Love
Jet - Are you Gonna Be My Girl
John Cougar Mellencamp - Hurts So Good
Judas Priest - You Got Another Thing Coming
Kiss -1 Wanna Rock and Roll All Night
Loverboy - This Could Be The Night
Lynyrd Skynyrd - Smell That Smell
Molly Hatchet - Flirting With Disaster
Mony Mony - Save A Horse - Pink Cadillac - Mixed by D. J. DeDo Brown
Night Ranger - Goodbye
Pink Floyd - Another Brick In The Wall
Queen - Fat Bottomed Girls
Queensryche - Silent Lucidity
REO - Can't Fight the Feeling Anymore
Reo Speedwagon - Feel Like Makin Love
Sammy Hagar - Mas Tequila
Skid Row - Ill Remember You
Stevie Ray Vaughn- Mary Had a Little Lamb
Van Halen - Love Comes Walking In
Warrent - Heaven Is Just To Far Away
White Snake - Here I Go Again
