Der Wildeste unter Tausend
Drama

Unter Ritts Führung gelang Paul Newman mit seiner Rolle des Hud Bannon eine Oscar®-nominierte Darstellung des rebellischen Sohns eines angesehenen Farmers, der im ständigen Konflikt mit seinem alternden Vater lebt. An der Seite von Newman erhielten Patricia Neal (Ein Mann wie Sprengstoff, Frühstück bei Tiffany) und Melvyn Douglas (Ninotschka, Willkommen Mr. Chance) für ihre Rollen einen Oscar®.
Sieben Oscar®-Nominierungen waren das Ergebnis dieser Zusammenarbeit des gefeierten Regisseurs Martin Ritt (Der Strohmann, Das Jahr ohne Vater, Norma Rae) mit Paul Newman.
	


Regie: 	Martin Ritt
Darsteller: 	Paul Newman, Patricia Neal, Whit Bissell, Melvyn Douglas, Brandon de Wilde
Land/Studio: 	USA, © 1963 Paramount
Erschienen: 	04.11.2004
Originaltitel: 	Hud
Altersfreigabe: 	16
Genres: 	
Drama
Collections: 	
Filmtipp: 	
Länge: 	107
DVD-Features: 	
Sprachen: 	Deutsch, Englisch, Französisch, Italienisch, Spanisch
Untertitel: 	Engl. f. Hörg., Englisch, Arabisch, Bulgarisch, Dänisch, Deutsch, Finnisch, Französisch, Griechisch, Hebräisch, Niederländisch, Isländisch, Italienisch, Kroatisch, Norwegisch, Polnisch, Portugiesisch, Rumänisch, Schwedisch, Serbisch, Slowenisch, Spanisch, Tschechisch, Türkisch, Ungarisch
Format: 	2,35:1
Ton: 	HiFi Mono
Dolby Digital 1.0
