Lite mer musik från klubben Sin-tetico (<a href="http://www.festa.se" target="_blank">www.festa.se</a>)
Lite nytt och lite gammalt som jag inte tröttnat på än i slumpvis ordning.


Pleasure From The Bass (Extended Mix)	 - <b>Tiga</b>
get paid	 - <b>Rhythm king and her friends</b>
Bike Thief	 - <b>Freezepop</b>
Restless (Rex The Dog Remix)	 - <b>JX</b>
Italian Fireflies	 - <b>Black Strobe</b>
Nuit Blanche	 - <b>Vive La Fête</b>
Radio (Rex The Dog Remix)	 - <b>Client</b>
Photographic (Rex The Dog Dubb Mix)	 - <b>Depeche Mode</b>
Prototype	 - <b>Rex The Dog</b>
I Look Into Mid Air	 - <b>Rex The Dog</b>
Frequency	 - <b>Rex The Dog</b>
champagne days, cocaine nights	 - <b>abe duque</b>
Maquillage	 - <b>Vive La Fête</b>
Poney part 2 (Felix da Housecat remix)	 - <b>Vitalic</b>
Zombie nation	 - <b>Miss Kittin</b>
Keine Melodien	 - <b>Jeans Team</b>
My Radio (Mitgang Audio Remix)	 - <b>Solvent</b>
extensive care	 - <b>Crossover</b>
Wir tanzen im 4-Eck	 - <b>Stereo Total</b>

Det finns också en torrent med lite mer udda musik: <a href="http://tracker.piratbyran.org/torrents-details.php?id=3258231">Sin-tetico 12"</a>