*** An Awesome Electro House DJ Set Brought To You By: Ouwsephreak ***


TITLE: TONY SENGHORE DJ MIX 07-2007

TRACKLIST:

LES VIOLIN IVRES - AGORIA - ALAVI REROX - REROX
VOLTA - OLIVIER GIACOMOTTO REMIX - DEFINITIVE
FATT BOTTOM GIRLS ORG MIX - ROMAN PUSHKIN - MOSCOW DANCEFLOOR RECORDS
NUFREQUENCY - IS IT OVER? - TONY SENGHORE REMIX - REBIRTH
LET'S WORK - KURD MAVERICK - CR2
DIRTY - ??? - What is this track?
PLUTON - SEBASTIEN LEGER - MISTAKES
FEEL LIKE DANCIN - MICKY SLIM REMIX - FINGER LICKIN RECORDS
SHE WANTS ME - RICHARD DINSDALE - SPIN OUT RECORDS
HOT HOT HOTTER - LAIDBACK LUKE - JOIA
FANCY FOOTWORK - D_I_M DUB MIX - TURBO
EVERYWHERE - JOHN DAHLBACK - JOIA
YOURE MINE - TIM DELUXE DUB - GREAT STUFF
MARS - SEBASTIEN LEGER - MISTAKES
NOW ITS NOT SUMMER - JOHN DAHLBACK - SYSTEMATIC
CROP DUSTER - SHLOMI ABER & BAO - RENEISSANCE
ALCOOLIC - POPOF - AFV LIMITED
A THOUSAND NIGHTS - GREGOR TRESHER - GREAT STUFF
GAIL IN THE O - JOHN AQUAVIVA & DAMON JEE REMIX - DEFINITIVE RECORDINGS
FORWARD NAKED - VOLIQUE - LOVE TRIANGLE MUSIC
IRST TE - WORTHY - DIRTY BIRD
WIKID - CHRISTIAN HOFF REMIX - UMM 
THE BUMP - TONITE ONLY REMIX - CR2
CARRY ME AWAY - SEBASTIEN LEGER REMIX - RISING MUSIC
THE SCREETCH - THE SCREETCH - GREAT STUFF
MOVE MY BODY - TIGA - DIFFERENT
GET DUMB - STEVE ANGELLO, AXWELL, SEBASTIAN INGROSSO - SPECIAL PROJECTS
FREAKS - MOGWAI REMIX - SUPERSTAR
LEAVE THE LIGHT ON - COBRA DUKES - FREDO & THANG REMIX - PRESTEL
DISCO VOLANTE - IDA ENGBERG - ORIGINAL MIX - PICKADOLL