KUMMELI KULTAKUUME

http://imdb.com/title/tt0133906/

DVDDecrypter 1:1 Full movie

MOVIE:	100% full
sUBTITLES:	finnish, swedish
MENU:	YES
EXTRAS:	YES
LANGUAGE:	finnish DD 2.0

Aspect ratio:	16:9 Anamorfic
Movie length:	92 min
Year:	1997
Genre:	Comedy

Film tells about a man who's living in a mental hospital. One day He finds out that his relative, Kyrpa Jooseppi (trust me, you don't want to know what that means in english), who used to dig gold in Lapland back in 1940's. Back then there were Nazis in Finland who tried to blackmale gold from Jooseppi. Jooseppi and His Gold mining friends killed couple of Nazi's and buried them with a treasure. So it's all about man finding his Grandfathers gold treasure. The bad thing is, that there's still couple of old Nazies who are also after the treasure.

Cast overview, first billed only: 	
Heikki Hela	.... 	Janne-Petteri Broman/Naamanka	
Heikki Silvennoinen	.... 	Elmeri Hautamäki/Kyrpä-Jooseppi	
Timo Kahilainen	.... 	Dille/Erä-Jorma	
Heikki Vihinen	.... 	Jönssi	
Mari Turunen	.... 	Rasinkangas	
Kari Hietalahti	.... 	Kulokoski	
Jukka Puotila	.... 	Peter North	
Vesa-Matti Loiri	.... 	Eugen von Lahtinen	
Oiva Lohtander	.... 	Karl-Heinz Rummenigen	
Tapio Liinoja	.... 	Isä Aleksei	
Tuula Nyman	.... 	Lyyli-täti	
Kristiina Elstelä	.... 	Tyyne-täti	
Ritva Jalonen	.... 	Vanessa	
Kalle Holmberg	.... 	Poliisipäällikkö Kulkunen	
Vesa Vierikko	.... 	Herman Göring