In english, there is 42 songs for ITG PC/Mac and/or Stepmania.

Kauan odotettu suomalaisten step-artistien PRO-biisipaketti on JULKAISTU! Paketti sisÃ¤ltÃ¤Ã¤ 42 musiikkikappaletta. Jokaiselle kappaleelle on tehty 5 vaikeustasoa, kaikilla kappaleilla on mahtavat taustakuvat ja bannerit, parilta biisiltÃ¤ lÃ¶ytyy kunnon taustavideot ja melkein kaikilta lauletuilta kappaleilta lÃ¶ytyy lyriikat.

PRO-biisipaketti sisÃ¤ltÃ¤Ã¤ kappaleita ja niihin tehtyjÃ¤ nelipaneeli-tanssipelien step chartteja (askeleita) joita voi pelata ITG PC/Mac:llÃ¤ tai StepManialla.

Suosittelemme pelaamaan videot pÃ¤Ã¤llÃ¤ ja taustojen kirkkaus 50%, mikÃ¤li mahdollista. Taustakuvat ja videot on optimoitu tuolle 50% kirkkaudelle ja taustojen vaihdokset ja videot eivÃ¤t toimi jos pelin asetuksista on kielletty videot.


Bad Boy - Cascada
Bagpipes - Unknown artist
Bang Bang Mystery Man - Mary Jo feat. Cairbre
Breath - Sparker
Caramelldansen - Caramell
Cha Cha - Chelo
Civic Festhall - Mark Morgan
Daddy DJ - Daddy DJ
Damn Damn Drum - Hiroki Kikuta
Days Go By - Dirty Vegas
Death From Above - Machinae Supremacy
DXY! - TaQ
Eat it Raw - Infected Mushroom
Elysium - Scott Brown
Enchantment - Crispy
End of Sanity - St Fungus
Groove 2001 - Sho-T feat. Brenda
Heaven - DJ Sammy
Hello Meow - Squarepusher
Hithouse 1 - Scarf!
Holdimarssi - Oni
Home Again - Matt Ricks
Hong Kong Streets - Alexander Brandon
Juggernaut - Quattro
Key of the Twilight - See-Saw
Kill For Love - Ramon Zerano
Mambo No.5 - Lou Bega
Marisa Stole The Precious Thing - IOSYS OS
Miracle - Cascada
Paranoia ~Sky~ - NW180
Played-A-Live - Safri Duo
Ready For Love - Cascada
Ready Steady GO! - L'Arc en Ciel
Re-Sublimity - Kotoko
Second Reality - Purple Motion
Spybreak - Propellerheads
Take Me Back - KaW
Trim - Kobo
Vanessa - Suzaku
Vertex Delta - Silvia
What Is My Name - London MC
Viinaa! - Narcotic