Director: Neil Biswas
Writer: Neil Biswas
Release Date: 4 May 2006 (UK) more
Genre: Drama
Runtime: UK:75 min
Country: UK
System: PAL
Audio: English DD 5.1, Spanish DD 5.1
Subtitle: English, Spanish
Aspect Ratio: 16:9
Synopsis: Based on real events, Bradford Riots tells the story of the 2001 riots and their aftermath from the point of view of an Asian family
Format: DVD5 to DVD5
Compression: Without compression.

--------------------------------------------------------------------------------------------------------------------------------------------------------------------------------------------------------------------------------------------------------------------------------------------------------------------------------------------

DATOS DE LA PELÍCULA

TÍTULO ORIGINAL: Bradford Riots

AÑO: 2006

DIRECTOR: Neil Biswas

INTÉRPRETES: Sacha Dhawan (Karim), Victor Banerjee (Azad), Ahsen Bhatti (Faisal), Manjinder Virk (Shazia), Syed Ahmed (Aki)

DURACIÓN: 75 minutos

GÉNEROS: Drama, Cine Político, Cine Británico

SINOPSIS: Gran Bretaña, julio 2001. Karim, un estudiante de política, regresa a casa durante el verano y se encuentra con el clima de unas tensas relaciones raciales. Después de una serie de disturbios en otras áreas del norte de Inglaterra, parece que el Partido Nacional Británico (BNP) tiene a Bradford en el punto de mira para el próximo marzo. Al mismo tiempo, la policía, ha anulado el festival asiático anual local, ?el Mela?, debido a la posible violencia. Entre tal tensión, Karim vuelve con su padre enviudado. Azad, y su hermano mayor, Faisal, un Musulmán devoto que dirige una tienda de tela en el área paquistaní de la ciudad..

CRITICA: Basada en hechos reales. Cada uno que saque sus propias conclusiones...

DATOS DEL DVD

SISTEMA: PAL

AUDIO: Castellano Dolby Digital 5.1, Inglés Dolby Digital 5.1

SUBTÍTULOS: Castellano, Inglés

RELACION DE ASPECTO: 16:9



MÉTODO DE RIPEO

FORMATO: DVD5 => DVD5

COMPRESIÓN: Sin Compresión.

SUBIDA

INFO SUBIDA: ADSL 2+ /24h/7d