Andy Kim - Baby How'd We Ever Get This Way (stereo).mp3
Arbors - A Symphony For Susan.mp3
Arthur Conley - Funky Street.mp3
Barbara Acklin - Am I The Same Girl.mp3
Barbara Lewis - Make Me Belong To You.mp3
Beach Boys - Darlin' (Stereo Mix).mp3
Benny Latimore - Girl, I Got News For You.mp3
Bill Deal & The Rhondells - May I.mp3
Billy J. Kramer & The Dakotas - From A Window.mp3
Billy Joe Royal - The Greatest Love - Columbia Single.mp3
Bob Seger & The Last Heard - Persecution Smith.mp3
Candymen - Georgia Pines.mp3
Capreez - Rosanna.mp3
Chicago Loop - She Comes To Me 2.mp3
Chiffons - Nobody Knows What's Goin' On  (In My Mind But Me).mp3
Choir - It's Cold Outside.mp3
Classics IV - Change of Heart.mp3
Connie Stevens - Now That You're Gone.mp3
Crispian St. Peter - Your Ever Changin' Mind.mp3
Critters - Bad Misunderstanding.mp3
Dallas Frazier - Just A Little Bit Of You.mp3
Darrell Banks - Open The Door To Your Heart.mp3
Dave Dee Dozy Beaky Mick and Tich - Zabadak.mp3
Dee Jay & The Runaways - Peter Rabbit.mp3
Del Shannon - Under My Thumb.mp3
Dells - Wear It On Our Face (stereo).mp3
Devotions - Rip Van Winkle.mp3
Don and the Goodtimes - I Could Be So Good To You.mp3
Don Fardon - Indian Reservation.mp3
Donnie Brooks - Mission Bell (Original).mp3
Donovan - Season Of The Witch.mp3
Drifters - Saturday Night At The Movies.mp3
Dusty Springfield - Stay Awhile.mp3
Ed Ames - Apologize.mp3
Eddie Floyd - Raise Your Hand (hi-res stereo).mp3
Eddie Holland - Jamie.mp3
Eddie Rambeau - Concrete and Clay.mp3
Everly Brothers - Bowling Green (Stereo).mp3
Everpresent Fullness - Wild About My Lovin' - White Whale single.mp3
Evie Sands - Any Way That You Want Me.mp3
Evie Sands - Take Me For a Little While (CD).mp3
Eydie Gorme - If He Walked Into My Life Today.mp3
Fifth Dimension - Go Where Ya Wanna Go (Sta-Level processed).mp3
Five Americans - I See The Light .mp3
Fontella Bass - Recovery.mp3
Gabriel & The Angels - That's Life (That's Tough).mp3
Garry Miles - Look for a Star.mp3
Gary Lewis & The Playboys - Girls In Love (Sta-Level processed).mp3
Gene & Debbe - Go With Me (stereo).mp3
Genya Ravan & Ten Wheel Drive - Morning Much Better (vinyl).mp3
Gladys Knight & The Pips - The End Of Our Road.mp3
Goodies - The Dum Dum Ditty.mp3
Grass Roots - Where Were You When I Needed You.mp3
Harry Nilsson - I Guess The Lord Must Be In New York City.mp3
Howard Tate - Ain't Nobody Home (original).mp3
Jan and Dean - I Found a Girl.mp3
Jimmy Cross - I Want My Baby Back.mp3
Jimmy Ruffin - Gonna Give her All The Love I've Got.mp3
Keith - Tell Me To My Face.mp3
Kenny O'Dell - Springfield Plane 1968.mp3
Kirby St. Roman - Summer's Comin'.mp3
Last Word - Can't Stop Loving You.mp3
Lee Dorsey - Get Out My Life Woman - Amy single.mp3
Left Banke - Pretty Ballerina.mp3
Love with Arthur Lee - Seven And Seven Is.mp3
Lovin' Spoonful - Six O'Clock.mp3
Lulu - The Boat That I Row.mp3
Maxine Brown - If You Gotta Make A Fool of Somebody.mp3
Mel Gadson - Comin' Down With Love.mp3
Merry-Go-Round - Live.mp3
Mickey Murray - Shout Bamalama (hi-res).mp3
Mugwumps - Jug Band Music.mp3
Music Machine - The People In Me.mp3
Nancy Ames - Friends And Lovers Forever (Stereo).mp3
Newbeats - Everything's Alright.mp3
Nino Tempo & April Stevens - All Strung Out.mp3
Nitty Gritty Dirt Band - Buy For Me The Rain.mp3
Nitty Gritty Dirt Band - Candy Man.mp3
Noel Harrison - Suzanne.mp3
Ohio Express - Beg, Borrow And Steal (RARE STEREO 45 VERSION).mp3
Outsiders - Help Me Girl.mp3
Peggy Scott & JoJo Benson - Lover's Holiday.mp3
Poor - She's Got The Time (She's Got the Changes).mp3
Pozo-Seco  Singers - Time.mp3
Ray Smith - Hold Me Tight.mp3
Ray Smith - Rockin Little Angel.mp3
Razor's Edge - Let's Call It A Day Girl.mp3
Redeye - Games.mp3
Righteous Brothers - Go Ahead and Cry.mp3
Righteous Brothers - On This Side of Goodbye.mp3
Rivieras - H. B. Goose step.mp3
Robert John (Stereo!) - If You Don't Want My Love.mp3
Rose Garden - Next Plane to London.mp3
Roy Orbison - (Say) You're My Girl - Stereo!.mp3
Sandi Shaw - Girl Don't Come.mp3
Sandpebbles - Love Power.mp3
Sandy Posey - What a Woman In Love Won't Do.mp3
Spencer Davis Group - Somebody Help Me.mp3
Steff - Where Did She Go.mp3
Tokens - Greatest Moments In A Girl's Life - hi-res.mp3
