More cheese please you say??  Why certainly!!  Our Cheesemix 4 contest has
been kindly sponsored by Paris Stilton and is brought to you in association with
the brand new JK Rowling novel "DDRExtreme.co.uk and the Odour of the Cheesemix".

Tread carefully noble players, for the cheese has matured and is smelling rank!!

SONGLIST FOR PACK 2:

SONG TITLE - Artist (simfile author)

JUDGED:-
AGE! AGE! EVERY NIGHT - DJ Ozma (anonymous)
CAMELOT SONG - Monty Python (anonymous)
CHU! NATSU PARTY - 3nin Matsuri (anonymous) 
COCONUT - Kabuki (TakeWalker)
CRAZY AND WILD - GÃ¼nther and the Sunshine Girls (anonymous) 
DOLLY SONG - Holly Dolly (anonymous)
FASHION - John B (anonymous)
HEY JULIET - LMNT (anonymous)
HYPE MAN (TRUDOG '07) - TobyMac feat. Trudog (anonymous)
I AM CYBERELLA - Cyberella (Cloud)
IN MY HEART (OVRAR EURO MIX) - Tsukasa (anonymous)
JANKENPYON! - Minimoni (anonymous)
MOON (Sun Mix) - dj Taka feat. Erika / remixed by Akira Yamaoka (anonymous)
NE~E - Aya Matsuura (anonymous)
ROSA HELIKOPTER - Peaches (Akira)
SAMURAI PIZZA CATS - Shuki Levy feat. Michael Airington (anonymous)
SONG OF VACATION - Beautiful Day (anonymous)
STOP - Spice Girls (Super_Ray)
SUCKA SUCKA PIZZA - Franz Tornado & The Mozzarella Girls (anonymous)
SUPERGABBER - Hakkuhbar (anonymous)
THE LAST RHUMBA - JEAN MICHEL JARRE (Wellian)
TOMBER LA CHEMISE - Zebda (anonymous) 
VANILLA GORILLA - Zippers (anonymous)

NON-JUDGED:-
ALAMO - Ken Martin (#Infinity)
BASKETBALL - Lil' Bow Wow feat. Jermaine Dupri, Fabolous and Fundisha (anonymous)
CHACARRON MACARRON - El Chombo (anonymous)
DIDDLEY-DEE - The Cartoons (TakeWalker) 
DINNER PARTY - Dirty Sanchez (anonymous)
DotA - Basshunter (anonymous)
DSCHINGIS KHAN (Millennium Mix) - Dschingis Khan (anonymous)
EVERYBODY JAM - Scatman John (anonymous)
GENOM SCREAMS (BM GB2 Gotchamix ver.) - L.E.D. Light (anonymous)
GHOSTBUSTERS - DJ Yoshitaka (anonymous)
GO BANANAS - Kiki & Fancy (#Infinity)
LIMBO DANCE - DJ Ostkurve feat. David Hasselhoff (TakeWalker)
MY NAME IS SUPERGIRL (SUPER EURO MIX) - Supergirl (anonymous)
NAGISA NO GO-GO GIRL! - The do-nuts (anonymous)
REGGAE REGGAE SAUCE (PROPER TINGS) - Levi Roots (BEN.(SPEIRS) 7.0)
SAY CHEESE (SMILE PLEASE) - Fast Food Rockers (the_ditz)
SPACE FIGHT - Akira Yamaoka (RVN-G)
TANDEM - Halcali (anonymous)
THAT'S HOW I BEST SHAQ - Aaron Carter (Sakura_Guy)
U SURE DO - Strike (anonymous)
WELCOME! - Do As Infinity (Xythar)
YEAH! - Christine (anonymous)

TOTAL FILES IN PACK 2 - 45

Enjoy the cheese!!