Cream Summer 2007

CD1 
Yves Larock - Rise Up 
Booty Luv - Don't Mess With My Man (Thomas Gold Big Love Remix) 
Reverend & The Makers - Heavyweight Champion Of The World (Club Mix) 
Bob Sinclar & Cutee B Feat. Gary Pine & Dollarman - Sound Of Freedom (Original Club Mix) 
Freemasons - Ain't Nothing But A Heartache 
Todd Terry All Stars Feat. Kenny Dope, DJ Sneak, Terry Hunter & Tara McDonald - Get Down (Kenny Dope Original) 
Armand Van Helden - NYC Beat (Club Mix) 
Dave Armstrong - Love Has Gone 
Mr. V - Put Your Drink Down (Bob Sinclair Remix) 
Bel Amour - Bel Amour 2007 Part 1 (Jerry Ropero & Michael Simon Remix) 
Grant Nelson - Seasons Of Jack 
Martin Solveig Feat. Jay Sebag - Rejection (Bob Sinclair Remix) 
Byron Stingily - Get Up (Steve Mac Remix) 
Alan Braxe & Kris Menace - Lumberjack 
Pryda - Armed 
Gossip - Listen Up! (Tronik Youth Remix) 
Doc Da Funk - Real Love 
Aaron McClelland - Spirit (Vocal Mix) 
DADA Feat. Sandy Rivera & Trix - Lollipop (Acappella) 
De Souza Feat. Shena - Guilty (Eddie Thoneick Remix) 
CD2 
Arnos Cost & Arias - Magenta 
Robyn With Kleerup - With Every Heartbeat (Tong & Spoon Wonderland Remix) 
Freaks - The Creeps (Vandalism Mix) 
Gat Decor - Passion (Dave Spoon Remix) 
Eyerer & Chopstick Feat. Zdar - Make My Day (Vocal Club Mix) 
Claude Von Stroke - The Whistler (Vandalism Remix) 
Steve Angello & Sebastian Ingrosso - Umbrella 
D. Ramirez & Dmitry Bobrov - Pleasure Me 
Mark Knight Feat. Luciana From Portobella - Party Animal (Vandalism Remix) 
Federico Franchi - Cream (Original Remastered Version) 
Wink - Higher State of Consciousness (Dirty South & TV Rock Remix) 
John Dahlback - Blink 
Hardrox - Feel The Hard Rock 
Hoxton Whores - Friday Saturday Love 
LXR Vs Andrea Doria - Freak Me (Andrea Doria Remix) 
Funkerman & Fedde Le Grand Present 'F To The F' - Wheels In Motion 
Jordy - Lishious Raw (Vocal Mix) 
Spektrum - Kinda New (Dirty South 07 Remix) 
Dominatorz - Do You Love Me 
Lifestylerz Feat. Honey Couture - Creep Delight (Hollywood Hills Honeylectro Mix) 
CD3 
Filo & Peri Feat. Eric Lumiere - Anthem (Nic Chagall Remix) 
Tom Day - Whisper 
J rgensen - Untitled 
Flash Brothers - Say Yeah 
Ito & Star - Sudoku Kid 
Dubfire - Roadkill (Cedric Gervais Remix) 
Djuma Soundsystem - Les Djinns 
John Acquaviva Pres. Swen Weber - First Stroke 
Robot Needs Oil - Volta 
TV Rock Vs Dukes Of Windsor - The Others (Club Mix) 
DJ Jeroenski - Back Once Again 
Jimmy Chronic - Lemondrops (Mark Webb Remix) 
Cosmic Gate - Analog Feel (Extended Version) 
Ricky Fobis - Nobody 
Randy Katana - Session Impossible 
Bedrock - Heaven Scent (Greg Downey Remix) 
CRW - I Feel Love (P.H.A.T.T. Remix) 
Kirsty Hawkshaw Meets Tenishia - Outsiders (Cosmic Gate Remix) 
Dogzilla - Frozen 
DT8 Project - The Power Of One 
