Rls Name : VA - Magic Mix Vol 7

Rls Date : Feb-23-2007
Street Date: Feb-24-2007
Rls Type : Sampler
Company : Ruhrpott Records
Genre : Dance
Source : CDDA
Tracks : 01


Encoder : LAME 3.97 V2: preset standard
Quality : VBRkbps / 44.1kHz / Joint-Stereo
Bitrate : avg. 194kbps


VA - Magic Mix Vol 7

01 VA - Intro
02 VA - Magic dance
03 VA - House Arrest
04 VA - Downtownmix




Magic Dance

Opening
Liz Kay - When Love Becomes A Lie
Nordic Stars - Jump Jump
Lockhard - The Summer Is Magic
Mental Madness Allstars - The Anthem
Sonic Alive Feat. Kate Lesing - I've Got The Love
Bounce Brigade - Move Your Feet
DHT Feat. Edmee - I Go Crazy
Rodick - Any More
Tune Up Vs. Italobrothers - Colours Of The Rainbow
Gabry Ponte - UNDERGROUND
Triple Bounce - Magic Melody
Dan Winter - How Does It Feel
Yom Trax - The Sound
Melanie Flash - Halfway To Heaven
Steve Twain Pres. Escape One - Numero Uno
H2K - Summermelody
Dancetech Vs. Tune Up - Ride On Time
East Clubbers - Sextasy
Dancecore Allstars - When The Sun Comes Out
Jan Wayne - Peace Of My Heart
Klubbhoppers - Rain Again
Paffendorf Vs. The Real Booty Babes - Where Are You
Cascada - Truly Madly Deeply
Datura Vs. MNS - Infinity
Renegate Masterz - Nasty Girl
Rocco - Fucking Beautiful
Rave Allstars - Baem

House Arrest

Vendon - Take Me Shake Me
Junior Jack - Dare (Stupid Disco)
Eric Prydz Vs. Floyd - Proper Education
Jackie O - I Dont Feel Like Dancing
Dutch Mafia - Break My Stripe
Lazard - Your Heart Keeps Burning
Cut N Paste - Son Of A Preacher Man
Groove Cats - Once In A Lifetime Groove
Yanou Feat. Liz - King Of My Castle
Vinylshakerz - Love Is A Fragile Thing
Sharam - P.A.T.T (Party All The Time)
Rune - Calabria
Scotty - God I A DJ 07
Royal Gigolos - Tell It To My Heart
Dirt Brothers - Girls Just Want To Have Fun
2 4 Grooves - The Way I Do
Alex M - I Cant Stand It
Picco - Back 2 Hawaii

Downtownmix

Justin Timberlake - What Goes Around Comes Around
Xavier Naidoo - Was Wir Alleine Nicht Schaffen
Moses Pelham - Gott Liebt Mich
Beyonce - Irreplaceable
George Michael Feat. Mutya - This Is Not Real Love
Lunik - Life Is All Around
Blue Lagoon - What Becomes Of A Broken Heart
Naturally 7 - Feel It (In The Air Tonight)
Nelly Furtado - All Good Things (Come To An End)
Aksent - Krunk Krunk
Us5 - In The Club
Lumidee Feat. Tony Sunshine - Shes Like The Wind



