Härligt dubbelalbum med svenska guldkorn! 

Enjoy!

CD 1
Av längtan till dig - Åsa Jinder & CajsaStina Åkerström
Vem tänder stjärnorna - Eva Dahlgren
Det vet bara jag - Totta Näslund (Duett Med Jenny Öhlund)
Kärleken förde oss samman - Ulf Lundell
För kärlekens skull - Ted Gärdestad
Det vackraste mötet - Rikard Wolff
Sång till friheten - Björn Afzelius
Där gullvivan blommar - Grymlings
En fisk i en skål - Stefan Sundström
Mitt hjärta är ditt - Rolf Wikström
Little Willie John - Peter LeMarc
Som en bro över mörka vatten - Helen Sjöholm & Anna Stadling
Hon kom över ängarna - Mikael Wiehe
Ta mig till havet - Peter Lundblad
Nu blåser vi ut ljusen - Lasse Tennander
Jag ger dig min morgon - Fred Åkerström


CD 2
Lilla vackra Anna - Finn Kalvik
Beatrice - Kalle Moraeus
Älska mig - Ainbusk Singers
Benen i kors - Lisa Ekdahl
Brev från kolonien - Wille Crafoord
Vilken underbar värld - Anders Ekborg
Kristallen den fina - Louise Hoffsten
Vintersaga - Monica Törnell
Fråga stjärnorna - Cajsa-Stina Åkerström
Ett liv för mig - The Real Group
Nocturne - Elisabeth Andreasson
Dansen på Sunnanö - Freddie Wadling
Bedårande sommarvals - Monika Zetterlund
Ballad om Fredrik Åkare & den söta Cecilia Lind - Cornelis Vreeswijk
Deirdres samba - Anne-Lie Rydé
Underbart är kort - Povel Ramel
