[b][size=3] Song Mix[/size]
2_black_-_waves_of_luv.mp3
50_cent_-_fire.mp3
Alicia Keys - Like you'll never see me again.mp3
Amy Winehouse - Will You Still Love Me Tomorrow.mp3
Blondie - One Way Or Another.mp3
chingy_ft._amerie-fly_like_me.mp3
Duane Eddy - Peter Gunn.mp3
Etta James - I Just Want To Make Love To You.mp3
Fabolous - Baby Don't Go (Feat. T-Pain) (www.music-bg.org).mp3
Kanye West - Flashing Lights Feat Dwele.mp3
Laura Pausini Michael Buble - You'll Never Find Another Love Like Mine.mp3
Leona Lewis - Bleeding Love.mp3
Little Richard - GOOD GOLLY MISS MOLLY.wma
lupe_fiasco_ft._matt_santos-superstar.mp3
Mel Torme - Secret Agent Man.mp3
Passion - So Sick (Acoustic - Ne-Yo - So Sick) (woshia).mp3
Paul McCartney - All Shook Up.mp3
Peggy Lee - Fever.mp3
Semisonic - Secret Smile.mp3
Simply Red - Stars.mp3
Sixpence None The Richer - Kiss Me.mp3
Sting & Eric Clapton - It's Probably Me (acoustic).mp3
Terence Trent D' Arby - Sign Your Name.mp3
The Corrs - What Can I Do.mp3
The Dandy Warhols - Bohemian Like You.mp3
The Troggs - Wild Thing.mp3
X-Press 2 Feat. David Byrne - Lazy.mp3



[size=3]RELAX[/size]
Al Di Meola - Splendido Sundance.mp3
bahramji_and_maneesh_de_moor-crazy_heart.mp3
caravelli-love_story.mp3
Chick Corea_Spectacle.mp3
dan_fogelberg_and_tim_weinsberg-paris_nocturne-bnl.mp3
Eternal - Angel Of Mine.mp3
Gary Moore - Still Got The Blues (For You).mp3
Gotan Project - Chunga's Revenge.mp3
Hil Street Soul - Until  You Come Back To Me.mp3
Instrumental - Jazz - Romantic Sax - Sensual Music.mp3
jim_brickman-heaven-bnl.mp3
john_williams-cavatina-bnl.mp3
King Cole Trio - After You Get What You Want, You Don't Want It.mp3
Massive Attack featuring Tracey Thorn - Protection.mp3
Moby - Find My Baby.mp3
Nat King Cole - UNFORGETABLE.mp3
niraj_chag-the_nomad.mp3
Norah Jones - Come Away With Me.mp3
plumb-in_my_arms.mp3
Raul Orellana Feat.J.Bonell - Entre Dos Aquas.mp3
Relaxation - Acustic Alchemy - Best of Smooth Jazz Guitar Pl.mp3
Sax for Sex v.1 - 01 - Stewart.mp3
Thievery Corporation - Lebanese Blonde (Instrumental).mp3
yanni-in_the_morning_light-bnl.mp3 [/b]