Regie:  	Edward Buzzell
Darsteller: 	William Powell, Myrna Loy, Keenan Wynn, Dean Stockwell, Phil Reed, Gloria Grahame, Patricia Morison
Land/Studio: 	USA, Ã?ï¿½Ã?Â© 1947 Warner
Erschienen: 	30.09.2005
Originaltitel: 	Song of the Thin Man
Altersfreigabe: 	12
Genres: 	
KomÃ?ï¿½Ã?Â¶die/Thriller
Collections: 	
Filmtipp: 	
LÃ?ï¿½Ã?Â¤nge: 	83
DVD-Features: 	* Kurzfilm A Really Important Person
* Cartoon: Slap Happy Lion
* USA-Kinotrailer
Sprachen: 	Deutsch, Englisch, Spanisch


Untertitel: 	Deutsch, Englisch, Spanisch, Turkisch,
 
Finnisch, Griechisch, Kroatisch, Portugiesisch, Schwedisch, Ungarisch



Format: 	1,33:1/4:3
Ton: 	HiFi Mono
Dolby Digital 1.0



 
http://www.imdb.com/title/tt0039853/