Top 100 Trance and Techno Party Songs of All Time:

Alice Deejay - Better off alone
Antiloop - Believe
Antiloop - Only U
Armand Van Helden - My My My 2006 (Stonebridge Remix)
ATB - 9pm (Till I Come)
ATB - Ayla
ATC - Around The World
Banana Inc. - Club Kink
Barcode Brothers - Flute
Base Attack - Techno Rocker
BassHunter - Boten Anna
BassHunter - Russia Privjet
Beatfreakz - Somebodys Watching Me (Hi Tack Remix)
Benny Benassi - Satisfaction
Benny Benassi Bross - Every Single Day
Bob Marley vs. Funkstar De Lux - Sun is Shining
Bob Sinclar - World Hold On
Booty Luv - Boogie 2night
Creambase - Fiddle 2003
Dance 2 Trance - Power Of American Natives Ã?Â´98
Dance Nation - Move Your Love (UK Radio Edit)
Dancing DJs vs Roxette - Fading Like A Flower
Danzel vs Dj F.R.A.N.K. - My Arms Keep Missing you
Darude - Feel The Beat
Darude - Sandstorm
David Guetta vs The Egg -Love Dont Let Me Go (walking away)
Dj Aligator Project - The Whistle Song
DJ Antoine - Arabian Adventure 2
Dj Dream - Hoppesangen
Dj jean - The Launch
Dj Jose vs G Spott - House of Justice
Dj Jose vs G Spott - Wrong is Right
DJ Mangoo - Eurodancer
Dj Mystik - China
Dj Sammy and Yanou - Heaven
Dj Satomi - Castle In The Sky
Dj Satomi - Waves
DJ Sona - Xplosion
DJ Tiesto - Theme From Norefjell
Dra PÃ?Â¥ - FlÃ?Â¸ytesangen
Drunken monkey - Calabria
East Clubbers - Beat Is Coming
East Clubbers - Sextasy
Eric Prydz - Call on Me
Estima - Hitmans Paradise
Faithless - Insomnia
Fedde Le Grand - Put Your Hands Up for detroit
French Affair - sexy
Galaxee - Lullaby
Gigi D\'Agostino - Baci Abbracci
Gigi D\'Agostino - LÃ?Â´Amour Toujours
Gigi D\'Agostino - The Riddle
Gigi D\'Agostino - you spin me round
Global Deejays - Get Up 2007
Global Deejays Vs Benny Benassi - San Fransisco Dreaming
Hi Tack - Say Say Say (waiting 4 u)
Il Caesar - Calma
Interphase - Dr Feelgood 2003
John Parr vs Tommyknockers - New Horizon
Junior Jack - Dare Me vs Stupidisco
Leszek Piesek - Hau Hau
Lightforce - Eternity
Loleatta Holloway - Love Sensation 06
Mason Vs Princess Superstar - Perfect Exceeder
Master Blaster - Hypnotic Tango
Mauro Picotto - Komodo
Mauro Picotto - Proximus
Meck feat Leo Sayer - Thunder In My Heart Again
Michael Gray - Weekend
Milk and Sugar - What is love
Mylo feat Miami Sound - Machine Doctor Pressure
Pakito - Living on video
Paul van Dyk - For an Angel
Prodigy - Smack My Bitch Up
Pulsedriver - The Whistle Song
Rocco - Drop The Bass
Roger sanchez - Another Chance
Rollergirl - Superstar
Salt \'n Pepa - Push It (DJ Tonka Remix)
Sander Kleinenberg - This is not Miami
Sash! - Ecuador
Scooter - Aiii Shot The Dj
Scooter - One (Always Hardcore)
Sharam - Party All The Time
SkyMarshall Arts - From Paris to Berlin Redux
Snap -  Rhythm is a Dancer
Sonique - It feels so Good
Special D - Come with me
Steve Angello - Davali
Studio B - I see Girls
Sunblock feat Robin Beck - First Time
Sunblock ft. sandy - Baby Baby
Sunloverz - Shine On (Heiko & Maikos Gute Laune Remix)
Sunset Strippers - Falling Stars
Supermode - Tell Me Why
Team deep - Morning light
The Planets - Contradanza (Almighty Radio Edit)
Till West & DJ Delicious - Same Man (Radio Edit)
United Nations - Out of touch
Zombie Nation - Kernkraft 400

Includes front cover and playlist.

I dont have the best connection, so seed everyone!





