All of the videos from the Sonic Vegemite Mugen: The New Challengers tournament. Please note that all characters are controlled by CPU.

Teams
A *star* indicates a victory.

You will all hate me. - Breaker
Dragonclaw - Cyber Akuma - Jedah

Team Paper Bag - Sho **
Kusanagi - Terry Bogard - Dark Chun-Li

IT IS EPIC CHEESE - Cheesy *
Ryu - Gou Hibiki - Ella
Parched Earth

Team 666 - Metaler
Zero (MM) - Spider-Man - Ryo (CVS)

Viva La Dio - Kage
Shadow Dio - Dio - Baby Bonnie Hood

Don\\\'t Stop Me Now - D ***
God Rugal - Thor - Master Ryu

Guess how tough I am you Dumbarse - DIRGE *
Kuando - Juggernaut - Ubu

More/Less The Usual, mon ami - Neotails8762
Sonic - Sol - Robo Ky
Cyber

Stay back - Tronic
Shin Akuma - Guy - Kim Dong Hwan

Team Glomp! - BishounenTaurus **
Sailor Jupiter - Marco - Morrigan

Osnaps - Lightnix
Carnage - Another Kyo - Ryo (KOF)

It\\\'s too damned late for good ones - Fiery *
Venom - Captain Commando - Chun Li

Emo Pants
Superman - Bizarro - Kung Fu Man

Striding Evil Roses - Max FÃ¼chs ***
Rose - Evil Ryu (CVS Edit) - Strider Hiryu

Team Bojangles - Neo_cydude *
Sub Zero - Dhalsim - Storm

Team.EXE - Reck
Hulk - Roll - Dan