Tracklist:

Delerium - Angelicus
Johan Gielen - Revelations
Art Meson - Manureva 2007
Tiesto feat. Christian Burns - In The Dark
4 Strings feat. Tina Cousins - Curious (Sam G Remix)*
Paul van Dyk feat. Jessica Suta - White Lies (Berlin Vocal Mix)*
Koishii & Hush - Time After Time
Regi feat. Scala - I Fail
Andrew Spencer & The Vamprockerz - Zombie (Ray Knox Remix)*
Scooter - Lass Uns Tanzen
Groove Coverage - Because I Love You
DJ Magic - Inside
Pakito - Are You Ready
Alex C feat. Y-Ass - Du Hast Den SchÃ¶nsten Arsch Der Welt (Basshunter Remix)*
Akon - Smack That (Stian K vs. Banana Inc. Remix)
DJ Magic vs. Max Farenthide - Get Down
Britney Spears - Gimme More (DayDream Remix)*
Scooter - The Question Is What Is The Question
DJ Porny - Je T'aime Porny
Sean Kingston - Beautiful Girls (Silver Nikan Remix)*
Milk Inc. - Sunrise (Jeckyll & Hyde Remix)
Alex Gaudino feat. Crystal Waters - Destination Calabria
Enur feat. Natasja - Calabria
Fireball vs. Bob Sinclar - What I Want
Sunblock feat. Sandy - Baby Baby
Josh Wink - Higher State Of Conciousness 2007
Calvin Harris - The Girls
Corenell vs. The Lisa Marie Experience - Keep On Jumpin'
Felix Da Housecat - Something For Porno
Armand van Helden - NYC Beat
David Guetta feat. Chris Willis - Love Is Gone
Richard Grey - Warped Bass
Houzecrushers - Touch Me
Danny - Play It For The Girls
Alibi vs. Rockefeller - Sexual Healing
De Souza feat. Shena - Guilty
Electric Junkies - My Drug (Is Electro)
Rihanna - Don't Stop The Music (Jody den Broeder Remix)
Cascada - What Hurts The Most (Topmodelz Remix)
DJ Analyzer vs. D-JMC - We Belong (Basslovers United Remix)*
Kim Sozzi - Break Up (Cascada Remix)
Manian feat. Aila - Heaven (Discotronic Remix)*
Cascada - Truly Madly Deeply (Tune Up! Remix)
Timbaland feat. Keri Hilson - The Way I Are (Stian K & DJ Excellence Remix)*
Central Seven - If I Were You (Rocco & Bass-T Remix)*
Lazard - Your Heart Keeps Burning (Rob Mayth Remix)*
Darude - Tell Me
Out Of Office - Hands Up
Martijn den Velden feat. Luciana - I Wish U Would
Super Mal feat. Luciana - Bigger Than Big
Danzel - You Spin Me Round (Like A Record)
David Guetta - Baby When The Light (David Guetta & Fred Rister Remix)*
Camille Jones vs. Fedde le Grand - The Creeps
The Beach & Tia - Suntan
Michael Mind - Blinded By The Light
Uniting Nations - Do It Yourself (Go Out And Get It)
Junior Jack - Dare (Stupidisco)
Master Blaster - Walking In Memphis / Can Delight (Video Mix)
Ultra Flirt - Heaven Is A Place On Earth (Discotronic Remix)*
Frisco vs. Ice MC - Think About The Way
Nelly Furtado - Say It Right (Delaction Remix)*
Kate Ryan - Voyage Voyage (Central Seven Remix)*
Liz Kay - When Love Becomes A Lie (Cascada Remix)
Yumm Yumm - Happy Day (Vasco & Millboy Remix)
Natacha & Dominique - Get A Life
Inga From Sweden - My Name Is Inga
Shaun Baker - VIP (Dan Winter Remix)*
Scooter - Behind The Cow
ATB - Feel Alive (Duende Remix)*
Armin van Buuren - The Sound Of Goodbye (Blank & Jones Remix)*
Naksi vs. Brunner - Somewhere Over The Rainbow (DJ Klubbingman Remix)*
DJ Jean - Sexy Lady (Headhunters Remix)*
Verka Serduchka - Dancing Lasha Tumbai (Dith & Partystylerz Remix)*
Lene Alexandra - My Boobs Are OK

