adam freeland - supernatural things (dj deejay edit remix)
adam freeland - we want your soul (dj deejay edit remix)
alexei sayle - didnt you kill my brother (dj deejay edit remix)
Ananda Project N.Hitchcock - Can You Find The Heart (dj deejay edit remix)
Annie - Chewing Gum (dj deejay edit remix)
armin van buuren - another day (dj deejay edit remix)
armin van buuren ft. justine suissa - burned with desire (dj deejay edit remix)
Art Of Trance - Love Washes Over (dj deejay edit remix)
Astral - Now and forever (dj deejay edit remix)
ATB - I Dont Wanna Stop (dj deejay edit mix)
ATB - Long Way Home (dj deejay edit remix)
Aubrey - I'm Waiting (dj deejay edit remix)
Aurora - Sleeping Satellite (dj deejay edit remix)
Becky Baeling - getaway (dj deejay edit remix)
blank & jones - Desire (dj deejay edit mix)
Blue Man Group - I Feel Love (dj deejay edit remix)
Boogie Pimps - Somebody To Love (dj deejay edit remix)
Boomkat - What U Do 2 Me (dj deejay edit remix)
britney spears- toxic (dj deejay edit remix)
BT - Somnambulist (dj deejay edit mix)
BT feat. jc chasez - the force of gravity (dj deejay total remix)
Christina Aguilera - Beautiful (dj deejay edit remix)
christina milian - whatever you want (dj deejay total remix)
Coldplay - Clocks (dj deejay edit remix)
colourful kharma - for the music (dj deejay edit remix)
Cooler Kids - Morning Star (dj deejay edit remix)
Da Buzz - Wanna Be With Me (dj deejay edit remix)
Daniel Bedingfield - If You're Not The One (dj deejay edit remix)
Dannii Minogue - I Begin To Wonder (dj deejay edit remix)
David Guetta - Just a Little More Love (dj deejay edit remix)
david morales ft. lea lorien - how would you feel (dj deejay total remix)
Deepest Blue - Deepest Blue (dj deejay edit remix)
dejure - sanctuary (dj deejay edit remix)
Delerium - truly (dj deejay edit remix)
Delerium ft Jael - After All (dj deejay edit mix)
Dirt Devils - Music Is Life (dj deejay edit remix)
Dirty Vegas - Days Go By (dj deejay edit remix)
DJ Errik - Fast cars and Bitches (dj deejay edit remix)
DJ Murphy Brown - Axel F 2003 (dj deejay edit remix)
DJ Sammy - Sunlight (dj deejay edit remix)
DJ Sammy feat. Bryan Adams - Heaven (dj deejay edit remix)
DJ Tomcraft - Overdose (dj deejay edit remix)
DT8 Feat. Roxanne Wilde - Destination (dj deejay edit remix)
Dub Pistols - Problem Is (dj deejay edit remix)
Eamon - Fuck It (uncensored dj deejay remix)
Ferry Corsten - Rock Your Body Rock (dj deejay edit remix)
Finley Quaye And William Orbit Feat. Beth Orton - Dice (dj deejay edit remix)
Future Breeze - Ocean of eternity (dj deejay edit remix)
Gardeweg - All I Want (dj deejay edit remix)
georgie Porgie - I Love I Love (dj deejay edit remix)
gwen stefani - what you waiting for (dj deejay edit remix)
Hex Hector Pres.Kim Sozzi - We Get Together (dj deejay edit remix)
iio - At The End (dj deejay edit remix)
iio- smooth vs runaway (dj deejay edit remix)
Information Society - Pure Energy (dj deejay edit remix)
inner city - good life (dj deejay edit remix)
jahkey b feat. satta - heartattack (dj deejay total remix)
Jaimeson - Complete (dj deejay edit remix)
Jakatta - One Fine Day (dj deejay edit remix)
James Holden - A break in the clouds (dj deejay edit remix)
Jason Nevins feat. HJ - I'm In Heaven (dj deejay edit remix)
Jennifer Lopez - I'm Glad (dj deejay edit remix)
Jethro Tull - Thick As a Brick (dj deejay all acoustic edit mix)
kevin aviance - give it up (dj deejay edit remix)
Kid Alex - Young Love Topless (dj deejay edit remix)
Kings2 of Tomorrow - Dreams 2003 (dj deejay edit remix)
Kosheen - All In My Head (dj deejay edit remix)
Kreo - Burn For You (dj deejay edit remix)
Kylie Minogue - Slow (dj deejay edit remix)
LC Anderson vs Psycho Radio - Right Stuff (dj deejay edit remix)
LFO - Freak (dj deejay edit remix)
Liquid People vs Talk Talk - It's My Life (dj deejay edit remix)
Love Committee - Love Rules (dj deejay edit remix)
Manijama feat. Mukuya - No no no (dj deejay edit remix)
Martin Solveig - Rocking Music (dj deejay edit remix)
Milk And Sugar - Let The Sunshine In (dj deejay dub remix)
milk and sugar - let the sunshine in (dj deejay edit remix)
Moguai - Get On (dj deejay edit remix)
moloko - forever more (dj deejay edit remix)
Motorcycle - As The Rush Comes (dj deejay edit remix)
Murk - Alright (dj deejay edit remix)
Murk - Believe (dj deejay edit remix)
Oceanlab - Sky Falls Down (dj deejay edit remix)
orielle - all i know (dj deejay edit remix)
origene - sanctuary (dj deejay total remix)
Overseer - Horndog (dj deejay remix)
Paul Van Dyk - Nothing But You (dj deejay edit remix)
pet shop boys - miracles (dj deejay edit remix)
Plummet - Damaged (dj deejay edit remix)
plump djs - Morning Sun (dj deejay edit remix)
Plump DJ's Gary Numan - Pray For You (dj deejay edit remix)
Puretone - Stuck In A Groove (dj deejay edit mix)
renaissance - a song for all seasons (dj deejay edit remix)
Saffron Hill - My Love Is Always There (dj deejay edit remix)
seal - Waiting For You (dj deejay edit remix)
Stacie Orrico - Stuck (dj deejay edit remix)
steppenwolf - magic carpet ride (dj deejay edit remix)
Sugababes - In The Middle (dj deejay edit remix)
Syntax - bliss (dj deejay edit remix)
Telepopmusik - Breathe (dj deejay edit remix)
The Bitch Hotel - Do U Wanna Dance (dj deejay edit remix)
The Roc Project feat. Tina Arena - Never (dj deejay edit remix)
The Scumfrog - Music revolution (dj deejay remix)
Thrillseekers - Dreaming Of You (dj deejay edit remix)
Tim Deluxe feat. Sam Obernik - It Just Won't Do (dj deejay edit remix)
Tina Ann - I Do (dj deejay edit remix)
Tommy Vee ft Diane Charlemange - You make Me Wanna (dj deejay edit remix)
Turin Brakes - Pain Killer (dj deejay remix)
Ultrabeat - Pretty Green Eyes (dj deejay edit mix)
utada hikaru - devil inside (dj deejay edit remix)
Way Out West - Muthafucka (dj deejay edit remix)
Wildlife - I Don't Want You (dj deejay edit remix)
will to power - fading away (dj deejay edit remix)
will to power - fading away (dj deejay re-edit remix)
zz top - Gimme All Your Loving (dj deejay edit remix)