COVER AT:www.voguehost.com/ims/u/zpy/capa/Figura1.jpg

SPECIAL EDITION INCLUDES 41 MUSIC VIDEOS.

ALLMOST 3 HOURS OF HIP-HOP BEATS (ALL DVD QUALITY).

Ice Cube ft Snoop Dogg + Lil Jon - Go 2 Church
Daddy Yankee ft Snoop Dogg - Gangsta Zone
Rick ross - Hustlin
Dre ft Rick Ross - Chevy Ridin High
Young Dro ft Ti - Shoulder Lean
Juvenile ft Paul Wall + Mike Jones - Way i be Leanin
Dj Khaled ft Lil wayne + Fat Joe ++ - Holla at me baby
Don Omar ft Nore + Fat Joe ++ - Reggaeton latino
T-Pain - Im n Luv wit a stripper (2) tha remix
TI - Why you Wanna
Too Short - Blow the Whistle
DMX - Lord Give Me a Sign
Yung Joc - I Know You See It
Bubba Sparxxx ft Mr. ColliPark - Heat it Up
Clipse ft Pharrell - Mr me too
Method Man ft Busta Rhymes - Whats Happenin
Janet Jackson ft Nelly - Call on me
Jennifer Lopez ft Fat Joe - Hold You Down
Pussycats Dolls - Beep
Pussycat Dolls ft Snoop Dogg - Buttons
Christina Milian ft Young Jeezy - Say I
Monica ft Dem Franchize Boyz - Everytime tha Beat Drop
Black Buddafly ft Fabolous - Bad Girl
Mashonda ft Snoop Dogg - Black Out
Tiffany Foxx ft Snoop Dogg - Shake That Shit
Nelly Furtado ft Timbaland - Turn off the Light (remix)
Cassie - Me & U
50 Cent ft Olivia - Best Friend (remix)
50 Cent ft Mobb Deep - Outta Control
Field Mob ft Ciara - So What
Chingy ft Tyrese - Pullin Me Back
Chris Brown ft Lil Wayne - Gimme That (remix)
Busta rhymes - I Love my Chick
Bow Wow ft J-Kwon - Fresh Azimiz
Nelly Furtado ft Timbaland - Promiscuous
LL Cool J - Control Myself
Lil Jon ft e-40 + Sean paul - Snap yo Fingers
Busta Rhymes - Touch it (remix)
NORE - Mas Maiz (remix)
Sergio Mendes - Mas Que Nada
Gnarls Barkley - Crazy

ALL THIS + CUSTOM MENU WITH TRACK SELECTION AND PIC PREVIEW.

AUDIO DOLBY DIGITAL 2.0 - WORKS ON PC/PS2/XBOX/DVD/ETC.

THIS COMPILATION WAS NEVER RELEASED A*N*Y*W*H*E*R*E.

HOPE YOU ENJOY, SO PLEASE POST YOUR COMMENTS

warezdvd@hushmail.com