SUPER! megaMIX utrzymany w klimacie techno-dance.   

Tracklist:

Nightwaves Feat. Nathan - We Are Free
Klubbingman - Revolution
Tune Up! - Pera Pera
Dyce - Tomorrow
Rob Mayth - Can I Get A Witness
Basic Elements - This Must Be A Dream
Lucamino - More Than This
Lazard - Little Star
Spirit And Crane - Mic 1 Check
Lucano Meets DJ Pain And DJ BassCap - El Rico
Dancefloor Rockaz - Wodka
Barcera - Secret Of Love
2 Brothers On The 1st Floor - The Drum Beat Goes
Akira - Wanna Be With You
Leona - Arguments
Glozzi - There Is The Girl
Sash - Equador 2005
DJ Nick - Hearts Entwine
Raccoon - Summer Vibez
Be Angel - Crystal Sea
Shaun Baker - Xplode 2
Floorfilla - Discoroller
Florida Inc. - Let Me Love You
Klubbdriver - Move Your Feet
DJ Manian - Heat Of The Moment
Be Pop - Prisluhni Skoljki
Avia Band - Vedno Ob Tebi
Liquido - Ordinary Life (Gigi D'Agostino Remix)
Yamboo And The Real Mapouka-Dancers - Mapouka
Global Deejays - Happy Station
Banaroo - Space Cowboys
Danzel - Put Your Hands Up In The Air
Bubble Toy - This One
Party Pimpz - Give It Up
Brothers - Don't Stop
The Early Years Part 2
Unit Feat. Red Bone - Move Your Body
General Base - I See You
Odyssey - Riding On A Train
General Base - Base Of Love
Twenty 4 Seven - Leave Them Alone
Dr. Alban - Let The Beat Go On
B.G. The Prince Of Rap - The Colour Of My Dreams
Black Rose - Melody
Mr. President - Up 'N Away
Outhere Brothers - Pass The Toilet Paper
Cappella - You Got To Let The Music
Loft - Love Is Magic
2 Brothers On The 4th Floor - Let Me Be Free
Matrix - Can You Feel It
Fun Factory - Close To You
Masterboy - I Got The Give It Up
Cappella - You And Me
Outhere Brothers - La La La Hey Hey
Playahitty - The Summer Is Magic
La Bouche - Sweet Dreams
Le Click - Tonight Is The Night
Dr. Alban - Look Who's Talking
Savage - Don't You Want Me
Ice MC - Think About The Way
Cappella - Move On Baby
Rednex - Cotton Eye Joe
Double You - Part Time Lover
Major T. - Keep The Frequency Clear
Whigfield - Saturday Night
Intermission - Piece Of My Heart
Twenty 4 Seven - Take Me Away
Andrew Sixty - Oh Carol
Prince Ital Joe & Marky Mark - Happy People
Haddaway - Rock My Heart
Double You - Part Time Lover
Chimira - You're Are So Vain
Outhere Brothers - Don't Stop
2 Brothers On The 4th Floor - Never Alone
Red Velvet - Lady Don't Cry
Natalie Browne - Torn
Melody MC - Free
20 Fingers - Short Dick Man
Energizer - Hit The Floor
Reel 2 Real - I Like To Move It 
_________________________________
Czas: 1:11:43 min