October 6th 2005


9.00-9.20pm 
Prodigy - 'Voodoo People (Pendulum Mix)' (XL Recordings) 
Alloy Mental - 'Gotta Love' (Skint)
Coburn - 'We Interrupt This Programme' (Data) 
London Elecktricity - 'Hanging Rock' (Hospital) 
Rhymefest feat Kanye West -  'Brand New' (J Records) 

9.20-9.40pm
Todd Terry - 'Keep On Jumpin' (Manifesto)
Benjamin Theves - ' Texas ' (Kitsune)
Britalics - 'I Can C Right Thru U' (Southern Fried) 
Drummatic Twins - 'Feeling Kinda Strange (Nick Thayer & Bass Kleph Mix)' (Fingerlickin)

9.40-10pm
Madonna - 'Hung Up (SDP's Extended Dub)' (Maverick) 
Damian Marley - 'The Master Has Come Back' (Universal)
Tiga - 'Pleasure from the Bass' (PIAS)

Annie Mac 's Mini Mix - London Elecktricity 
The Power Ballads Mini Mix 
Pendulum - 'Slam' (Breakbeat Kaos) 
Queen - 'We Will Rock You' (EMI) 
Logistics - 'Together' (Hospital) 
Europe - 'The Final Countdown' (Epic) 
High Contrast - 'Return Of Forever' (Hospital) 
Berlin - 'Take My Breath Away' ( Columbia ) 
London Elektricity - 'Billion $ gravy' (Hospital) 
Phil Collins - 'In The Air Tonight' (Virgin) 
Q Project - 'Ask Not' (CIA) 
Cindy Lauper - 'Time After Time' (White Label) 

10-10.20pm
Freddie Filter vs Basement Jaxx - 'Where's Your Head At?' (Masterstroke)
Akabu - 'Phuture Bound' (Z Records)
Drumsound and Bassline Smith - 'Breakdown' (Technique) 

10.20-10.40pm
Dangerdoom feat Cee Lo - 'Benzi Box' (Lex Records) 
Only Freak - 'Can't Get Away from Ur Love (Solid Groove Mix)' (Freerange Records)

Bangers & Mashed 
Vitalic - 'Le Roc 01' (International Deejay Gigolo) 
Finlay Quaye - 'Even After All' (Epic) 

10.40-11pm
Rosie Gaines - 'Closer Than Close (Reprise We Deliver Mix)' (SUSU)
Craggz And Parallel Forces - 'Love Me Insane' (Valve Recordings)
Sneaky Soundsystem - 'Hip Hip Hooray (Boogie Corporation Mix)' (Whack Records) 

12 Inches of 12's 
X Press 2 - 'Give It' (Skint) 

Kraak & Smaak - 'One Of These Days' (Jalapeno) 
Kreeps - 'All I Want To Do Is Break Some Hearts' (Output)