DJ Friendly pres. Top 50 Trax 2007 (part 1 - worldwidemix):


DJ Disse: Break on trough - Music For Dreams

Frankie Valli & The Four Seasons: Beggin\' / Piloosko re-edit - 679 Recordings

Juju Orchestra feat Leonhard & Callier: What is hip / Mo\'Horizons rmx - Harley & Muscle Productions

Gabriel Ananda: SÃ?Â¼ssholz / Ben Mono low level rmx - Music For Dreams

Lily Allen feat Wale: Smile / Mark Ronson DC rmx - Capitol

Dizzee Raszal feat Lily Allen: Wanna be - XL

Burial: Archangel - Hyperdub

Jamie Woon: Wayfaring stranger / Burial rmx - Live Recordings

Blue Foundation feat TrentemÃ?Â¸ller & Buda: As I moved on / Run Jeremy version - Okyo

Mat Zo: Foot & mouth - Praesul

Elektrons feat Eska: Dirty basment / Sumo rude rmx - Wall Of Sound

Samim: Heater - Get Physical

Vive La Fete: Love me, please love me / bonus rmx - Uncivilize World

Dirty South & MYNC Project: Everybody freakin / Piemont rmx - CR2

Sander Van Doorn: Grasshopper / SVD rmx - Oxygen

Deep Dish feat Sharam: The one - cdr

Fragma: Tocas miracle / Inpetto rmx - Tiger

Bob Marley: I shot the sheriff / Richard Grey rmx - Gut Active

Klaxons: Golden skans - Rinse

Qemists feat ID: Drop audio / 12\" mix - Ninja Tune

Polyploid: Just pray - Chill Tribe

Chemical Brothers: Burst generator - Freestyle Dust

Underworld: Crocodile - Underworldlive.com

Justice vs Simian: We are your friends - Ten Records

CocoRosie: Werewolf - Touch & Go



DJ Friendly pres. Top 50 Trax 2007 (part 2 - Scandinavian mix):

 
Peter BjÃ?Â¸rn & John: Young folks (Cousin Cole re-edit) - Wichita 

Sophia Somajo: Stockholm calling - Concrete Forest

Frida: Dunka mig gul & blÃ?Â¥ - cdr

Koop feat Yukimi Nagano: Come to me - Studio !K7

Houman Sebghati : Tuggartango - Jerusalem

Jay-Jay Johanson: Rocks in pockets - EMI

Familjen: Vad du vill - Hybris

Lykke Li: Little bit - LL

Juvelen: They don\'t love you (Sumo rebounce rmx) - Heya HiFi

Axwell feat Max C: I found u (remode) - Positiva

Cirez D: Tigerstyle - Mixmag

TrentemÃ?Â¸ller feat Ane Trolle: Moan (rmx) - Poker Flat

Jazzbox: How to build a chameleon - Music For Dreams

Ralph Myerz feat Christine Sandtorv: My darling - Beatservice

Xerxes: Angelina (MIU pick his olives from the sun rmx) - www.xerxes-music.com

Modan Garu: White noise - CCAP

Flunk: Blind my mind (Kohib rmx) - Beatservice

BjÃ?Â¸rn Torske: Fembussen hjem - Smalltown Supersound

LindstrÃ?Â¸m: Breakfast in heaven (DiskJokke rmx) - Feedelity

Lil\'Wolf: Deliver me (diskJokke & Vinny Villbass dub) - Rebirth

Ost & Kjex: Milano model (vox) - Dialect

Ronny Rabalder & Perrin: Great balls for hire - www.prepost.net

BjÃ?Â¸rn Kaarud & John Moss: Moods of Cayumba - Haiti Groove

Luxor: In the beginning (Rune LindbÃ?Â¦k rmx) - Beatservice

Flunk: Personal stereo (Wet Cookies rmx) - Beatservice


