Various Artists - Old Skoöl Of Rock

Trackliste: 



Kiss: Crazy Crazy Nights  
Alice Cooper: Poison  
Heart: Alone  
Poison: Unskinny Bop  
Warrant: Cherry Pie  
Cinderella: Gypsy Road  
Scorpions: Wind Of Change  
Terrorvision: Oblivion  
Twisted Sister: We´re Not Gonna Take It  
Billy Idol: White Wedding  
Rush: Spirit Of Radio  
Queensrÿche: Silent Lucidity  
Great White: Once Bitten Twice Shy  
Therapy: Nowhere  
Gun: Word Up  
Thunder: Dirty Love  
Lynyrd Skynyrd: Sweet Home Alabama  
ZZ Top: Gimme All Your Lovin´  
Europe: Final Countdown  
Whitesnake: Here I Go Again  
Mötley Crüe: Girls Girls Girls  
Skid Row: Youth Gone Wild  
David Lee Roth: California Girls  
Ratt: Round & Round  
Ugly Kid Joe: Everything About You  
Tesla: Love Song  
Kingdom Come: Do You Like It  
Vain: Beat The Butter  
L.A. Guns: Sex Action  
Mr Big: To Be With You  
Extreme: More Than Words  
Deep Purple: Burn  
Thin Lizzy: Waiting For An Alibi  
Rainbow: Since You´ve Been Gone  
Yngwie Malmsteen: Rising Force  
Dio: Stand Up And Shout  
Motörhead: Ace Of Spades  
Black Sabbath: Paranoid  
Judas Priest: Living After Midnight