Here's another selection of italo disco clips. 
Some requested by you ;-)

Sadly a few of them are in poor quality but I include them as they are one of its kind and very rare.

Enjoy! 
/neXium



--=   Best of Italo Disco Clips Vol 5   =--


Ago - Computer  
Bad Boys Blue - A World Without You (Michelle)
Bad Boys Blue - Come Back and Stay
Bandolero - Paris Latino
Bobby Orlando - Whisper to a Scream (Live 1986)
CC Catch - Strangers by Night
Danuta - Touch My Heart  
Den Harrow - Catch the Fox (Formel Eins)
Double Take - Rockola (Live @ EKB)
Fancy - Bolero
Fun Fun - Hitmix   
Gazebo - Trotsky Burger (Live @ DiscoRing)
Kathy Joe Daylor - With Every Beat of my Heart
Ken Laszlo - Glasses Man (Live Mp3 Edit)
Ken Laszlo - Hey Hey Guy (Live)
Magazine 60 - Don Quichotte (Live @ Extra Tour)
Matia Bazar - Ti Sento (Live @ Veronica)
Mike Mareen - Love Spy (Live-SR Ferienfestival)
Mysterious Art - Carma Omen 2 (Live)
New Baccara - Fantasy Boy (Eurotops)
Novo - Extremix (Musikladen)
O.K. - Okay (Live @ Hitparade)
Off - Electrica Salsa
Sandy Wilson - Gimme Your Love Tonight (Live @ Sky '86)
Savage - A Love Again (Live @ Disco Xenon)
Silent Circle - Moonlight Affair (Live)
Silicon Dream - Albert Einstein
Stacey Q - We Connect
Tapps - Runaway (Live in MÃ©xico)
The Twins - The Game of Chance (Musikladen)
Trans-X - Message on the Radio (Musikladen)
Two of Us - Two of Us (Live @ Peters Pop Show '85)


