Vou publicar a serie completa que e de 6 discos


Ha muitos, muitos seculos que o Homem procura sinais de vida inteligente nos ceus. Mas... e se eles ja ca estiverem?
"E um dos melhores programas em horario nobre, e ponto final"
O furacao "Eve" abate-se sobre Homestead, Florida. O resultado e a esperada tragedia: lares detruidos, fios electricos caidos, vidas desfeitas. Mas o inesperado tambem da a cara: ha algo de profundamente... diferente e arrepiante nas pessoas da cidade. Algo assustador. E talvez extraterrestre.
Siga os acontecimentos inesperados e revelacoes chocantes desta serie cheia de suspense criada por Shaun Cassidy, em que duas familias de Homestead - os Varons e os Underlays - revelam a verdade sobre eles mesmos e sobre a cidade. Eles sao tal como nos - familias com pais carinhosos, filhos que precisam de alguem que os encaminhe na vida e, claro, com uma ovelha negra. Neste caso, e Dave, um simpatico blogger desempregado que ve conspiracoes em todo o lado. E, em todas as conspiracoes, ve extraterrestres. So que desta vez, e capaz de ter razao!

Episodios
01. Pilot - Piloto
02. Lights Out - Luzes Apagadas
03. Watershed - Bacia Hidrografica
04. Alpha Male - Macho Alpha
05. Unnatural Selection - Seleccao Nao Natural
06. The Hunt - A Cacada
07. Fish Story - Historia do Peixe
08. The Cradle - O Berco
09. The Dredge - Draga
10. Origin of Species - A Origem da Especie
11. Us or Them - Nos ou Eles
12. Power - Poder
13. Redemption - Redencao
14. All God's Creatures - Todos Criaturas de Deus
15. The Nest - O Ninho
16. The Fittest - O Mais Forte
17. The Key - A Chave
18. Re-Evolution - Re-Evolucao
19. The Son Also Rises - Ergue-se O Filho
20. Run and Gun - Corre e Dispara
21. Round Up - A Recolha
22. The Last Wave Goodbye - A Ultima Onda
Extras

Qualquer anomalia informem, obrigado.		