Most songs are mp3's from 160 & up, some VBR,and Still Some AAC format(approx 5). (all play in itunes )Some are obscure, some are easily found. Something for all tastes. hope you enjoy it!
Albert Collins:Cold Cuts
April Wine: Oowatanite
Artful Dodger: Think Think
Big Sugar: Goodbye Train
Black Market Flowers: Mykel & Carli
Boneclub: Everything's On Fire
Boneshakers: Part Time Man
Budgie: In The Grip Of A Tyrefitter's Hand
Bugs Henderson: Blues In Reverse
Chicken Shack: Daughter Of The Hillside
Colin James: Hide
Dave Hole: You Got The Blues
David Werner: Love Is Tragic
Doyle Bramhall II: Green Light Girl
Ducks Deluxe: Don't Mind Rockin' Tonight
Duke Robillard: Stratisfied  (8min+ of blistering guitar!!!)
Earl Slick: A Change Is Gonna Come
Eliza Gilkyson: Mama's Got A Boyfriend
Elliott Randall: Sour Flower (rare live ver)
Gary Hoey: Mr Mover
Ginger: Solid Ground
The Grapes Of Wrath: You May Be Right
The Groove Hogs: Blues Is My Business(and business is good)
Hamell On Trial: Don't Kill & Downs(2 songs)
Jimmy Thackery: Lickin' Gravy
Joe Louis Walker: Blues Of The Month Club
Johnny Winter: Sen-sa-shun/got my mojo workin (live)
The Jonses: Boweevil Stomp
Killjoys(canadian):Soaked
Larry Davis: Texas Flood
Little Feat: Snakes On Everything
Lucifer's Friend: Ride The Sky
Luther Allison: Cherry Red Wine
Magic Slim & Teardrops: Chickenheads
Matthew Good Band: Load Me Up
Mean Gene Kelton & The Die Hards: Even Meaner
Monkeywalk: Panic Temporary
Montrose: I Got The Fire & Bad Motor Scooter (unreleased studio rehearsals)
Mystery Machine: Valley Song
Palidins: You & I
Paul "Earthquake" Pena: Gonna Move
Paul Cebar/Milwaukeeans: Don't Leave Me Listless
Plimsouls: Time Won't Let Me (live)
Popa Chubby: San Catri
Powderfinger: Waiting For The Sun
Pure: Pure
Rhinobucket:Pain
Robben Ford: In The Beginning
The Rosemarys: Higher
Royal Crescent Mob: Konk
Sherman Robertson: Guitar Man
Siegel-Schwall Band: Corrina
Silvertide: S.F.C.
Skyhooks: You Just Like Me 'cause I'm Good In Bed
Slobberbone: Placemat Blues
The Steepwater Band: Black Cat's Path
Sugarcult: She's The Blade
Too Many Cooks: Refuse To Die
Walter Trout & Radicals: I'm Tired
Widowmaker: El Doomo (live)stars ex spooky tooth guitarist