Disc 1

Kaiser Chiefs - Flowers In The Rain (The Move)
The Fratellis - All Along The Watchtower (Jimi Hendrix Experience)
Amy Winehouse - Cupid (Johnny Nash)
Robbie Williams - Lola (The Kinks)
The Streets - Your Song (Elton John)
Sugababes - Betcha By Golly, Wow (The Stylistics)
The Feeling - You're So Vain (Carly Simon)
Foo Fighters - Band On The Run (Paul McCartney & Wings)
Kylie - Love Is The Drug (Roxy Music)
K T Tunstall - Let's Stick Together (Bryan Ferry)
Franz Ferdinand - Sound And Vision (David Bowie)
The Raconteurs - Teenage Kicks (The Undertones)
Mika vs Armand Van Helden - Can't Stand Losing You (The Police)
Kasabian - Too Much Too Young (The Specials)
Keane - Under Pressure (Queen & David Bowie)
McFly - Town Called Malice (The Jam)
James Morrison - Come Back And Stay (Paul Young)
Gossip - Careless Whisper (George Michael)
The Pigeon Detectives - The Power Of Love (Huey Lewis & The News)
Lily Allen - Don't Get Me Wrong (The Pretenders)
 Disc 2

Stereophonics - You Sexy Thing (Hot Chocolate)
Mutya Buena - Fast Car (Tracey Chapman)
Editors - Lullaby (The Cure)
Razorlight - Englishman In New York (Sting)
Groove Armada - Crazy For You (Madonna)
Paolo Nutini - It Must Be Love (Madness)
The Kooks - All That She Wants (Ace of Base)
Mark Ronson - You're All I Need To Get By (Mary J Blige)
Calvin Harris - Stillness In Time (Jamiroquai)
Klaxons - No Diggity (Blackstreet)
Just Jack - Lovefool (The Cardigans)
Natasha Bedingfield - Ray of Light (Madonna)
The Twang - Drinking In LA (Bran Van 3000)
The Fray - The Great Beyond (REM)
Girls Aloud - Teenage Dirtbag (Wheatus)
Maximo Park - Like I Love You (Justin Timberlake)
The View - Don't Look Back Into The Sun (The Libertines)
Hard-Fi - Toxic (Britney Spears)
The Enemy - Father And Son (Yusuf and Ronan Keating)
Corinne Bailey Rae - Steady As She Goes (The Raconteurs)
