Estilo:Electro,House,Electro House


CD1:
1. Dada Life - This Machine Kills Breakfasts
2. Axwell, Ingrosso, Angello & Laidback Luke - Get Dumb
3. Atrocite Ft MQUE - Only You
4. Eddie Thoneick Ft Bonse - Together As One
5. Rob Lemon - Perfect
6. John Dahlb?ck - Everywhere
7. Patric La Funk Ft Jeremy Crowle - World Can You Handle It (House Dub)
8. Kevin Duval - This Is What It Sounds Like (Instrumental)
9. Lutzenkirchen - Music For The Girls
10. Bump - I?m Rushin (Dave Spoon Vocal Mix)
11. Johnny Crocket - E For Electro (Hi_Tacks Flipperkast Mix)
12. Funkerman & Fedde Le Grand Pres F To The F - Wheels In Motion
13. STFU - Shut The Fuck Up (Verdez Rmx)
14. Roger Sanchez - Not Enough (Dirty South Rmx)

CD2:

1. Mashup Kids - Love You (Chris Count % Dubster Mix)
2. Dada Life - The Great Fashionista Swindle
3. Rilectro Ft Peeet - I Don?t Like It (Electric Club Mix)
4. Mogi Ft Rochelle - Nation In A Funk (M-Dub)
5. Trick & Kubic - Believe
6. Acquaviva & Zenker - Swimming With Sharks
7. Erick Decks - Wild Obsession (Klaas Rmx)
8. Tetsuo - Disco Team (Napsugar Rmx)
9. Eto - Hideaway (Napsugar Rmx)
10. Acquaviva & L?tzenkirchen - Satellite (Pierce Rmx)
11. Margot - Torch (Rainer Weichhold Rmx)
12. Moguai - Ataque (Meat Katie Rmx)
13. Sikk - The Whisper (Club Mix)
14. Duck & Dog - It Sounds Like (DBN?s Elktrash Rmx)