Female - Various Artists Double Album, in MP3 format. Hope you enjoy!

Track list:

Gabrielle - Out Of Reach
Samatha Mumba - Body 2 Body
Jennifer Lopez - Ain't It Funny
Mary J Blige - Family Affair
Destiny's Child - Independent Woman
Macy Gray - Sweet Baby
Honeyz - Finally Found
Lauryn Hill - Ex Factor
3LW - No More
Diana Krall - The Look Of Love
Mica Paris - My One Temptation
Dinah Washington - Mad About The Boy
Joan Armatrading - Love & Affection
Sam Brown - Stop
Samantha Sang - Emotion
Dusty Springfield - You Don't Have To Say You Love Me
Oleta Adams - Get Here
Hazel O'Connor - Will You?
Eva Cassidy - Over The Rainbow
Nelly Furtado - I'm Like A Bird
Sophie Ellis Bextor - Take Me Home
Anastacia - Cowboys & Kisses
Jessica Simpson - Irresistible
Ellie Campbell - Don't Want You Back
Sugababes - Overload
Natalie Imbruglia - Torn
The Corrs - So Young
Kylie Minogue - Confide In Me
Jo Breezer - Venus & Mars
Emilia - Big Big World
Joan Osbourne - One Of Us
Suzanne Vega - Marlene On The Wall
Nerina Pallot - Patience
Shania Twain - You're Still The One
LeeAnn Rimes - Can't Fight The Moonlight
Cher - I Found Someone
Celine Dion - Think Twice
The Bangles - Eternal Flame
