SuperMan Ultimate Collector's - Disc 1

Director: Richard Donner
Writers: Jerry Siegel (creator: Superman) & Joe Shuster (creator: Superman)
Release Date: 8 February 1979 (Spain)
Genre: Action / Adventure / Fantasy / Sci-Fi
Cast: Marlon Brando (Jr-El), Gene Hackman (Lex Luthor), Christopher Reeve (SuperMan / Clark Kent), Ned Beatty (Otis), Jackie Cooper (Perry White)
Runtime: 146 min
Country: UK / USA
Audio: English DD 5.1, Spanish DD 5.1
Aspect Ratio: 2.40:1 , 16:9
Format: DVD9 (FULLDVD)
Compression: Without compression.

----------------------------------------------------------------------------------------------------------------------------------------------------------------------------------------------------------------------------------------------------------------------------

SuperMan Ultimate Collector's - Disco 1

DATOS DE LA PELÍCULA
TÍTULO ORIGINAL: SuperMan
AÑO: 1978
DIRECTOR: Richard Donner
INTÉRPRETES: Marlon Brando (Jr-El), Gene Hackman (Lex Luthor), Christopher Reeve (SuperMan / Clark Kent), Ned Beatty (Otis), Jackie Cooper (Perry White)
DURACIÓN: 143 minutos
GÉNERO: Aventuras
SINOPSIS: En una galaxia remota, un recién nacido es enviado por sus padres al espacio ante la inminente destrucción del planeta donde viven. La nave aterrizará en la tierra y el bebé -ya un pequeño niño-, es adoptado por unos padres granjeros que le inculcan los mejores valores. Con los años el joven se hará un hombre, irá a vivir a trabajar a Metrópolis donde, consciente de sus poderes sobrenaturales, los usará para intentar acabar contra el mal.
CRITICA: Famosa adaptación del cómic sobre el más popular de los superhéroes. Un gran reparto y una entretenida historia para un clásico del cine que gusta a niños y mayores. (FILMAFFINITY)
DATOS DEL DVD
SISTEMA: PAL
AUDIO: Inglés Dolby Digital 5.1, Castellano Dolby Digital Mono
SUBTÍTULOS: Castellano, Inglés
RELACION DE ASPECTO: 2.40:1 , 16:9
INFO EXTRA: Disco 1. Superman. La Película original de 1978. Menús interactivos, acceso directo a escenas, comentario del Productor Pierre Spengler y el Productor Ejecutivo Ilya Salkind, tráilers cinematográficos y anuncios de TV.
MÉTODO DE RIPEO
FORMATO: DVD9 => DVD9
COMPRESIÓN: Sin Compresión.
SUBIDA
INFO SUBIDA: ADSL 2+/24H