Batman(1989)
Action/Fantasy

Von dem maskierten RÃ¤cher Batman gejagt, stÃ¼rzt der Gangster Jack Napier in einen Kessel GiftmÃ¼ll, dem er grÃ¤sslich verunstaltet wieder entsteigt. Fortan terrorisiert er als "Joker" die Stadt Gotham. Der Joker entfÃ¼hrt die Fotoreporterin Vicky Vale und plant, die BevÃ¶lkerung Gothams bei einer gigantischen Parade mit Giftgas umzubringen. Das wiederum ruft Batman auf den Plan, der alle seine Wunderwaffen braucht, um mit dem teuflischen Joker fertig zu werden. Von den Zinnen einer alten Kathedrale stÃ¼rzt der Schurke schlieÃ?lich in den Tod.

Regie: 	Tim Burton

Darsteller: 	Michael Keaton, Jack Nicholson, Michael Keaton, Kim Basinger, Robert Wuhl, Pat Hingle, Billy Dee Williams, Michael Gough, Jack Palance

Land/Studio: 	USA, Â© 1989 Warner
Erschienen: 	25.09.1998
Originaltitel: 	Batman
Altersfreigabe: 	12
Genres: 	
Action/Fantasy
Collections: 	SuperkrÃ¤fte, Comic-Welten
Filmtipp: 	
LÃ¤nge: 	121
DVD-Features: 	* Zusatzinformationen zum Film


Sprachen: 	Deutsch, Englisch, Spanisch


Untertitel: 	Deutsch, Dt. f. Horg., Danisch, Engl. f. Horg., Englisch, Finnisch, Franzosisch, Griechisch, Hebraisch, Islandisch, Italienisch, Kroatisch, NiederlÃ¤ndisch, Norwegisch, Polnisch, Portugiesisch, Schwedisch, Spanisch, Tschechisch, Turkisch, Ungarisch


Format: 	16:9

Ton: 	HiFi Stereo
Dolby Digital 2.0
